####################################
#-*---------#+---------------------#
#----#------#----------------.-----#
#----#-----L#-----!----#-----------#
#----#----#####-------#######------#
#----#-----------------#-----------#
#-----------#-----###----###-------#
#--------####O-----#F----###---##--#
#-----------#------#-----------##--#
#---------------------------------@#
####################################
