####################################
#@-##+----------o------------------#
#---#--------##---------F----##----#
#---##-------##---#-----##---#-----#
#-------#---------#-----##---##----#
#-------###------.###-------------*#
#--###------------#-----##---#-----#
#--#L------###----#----------#-----#
#--##------###-------##---####-----#
#--------------!-------------------#
####################################
