####################################
#--@---------#---------------------#
#-------------#-----------#####----#
#----#----------------#-------#-O--#
#----######------.----#+------#----#
#--------F######------#####---#----#
#--------------#-----!-------------#
#------##-----------------L#####---#
#------##------#------######-------#
#--------------------------------*-#
####################################
